1111111111
1000000001
10C0000001
1000000C01
1111100001
10C1000001
100000E001
1001C00001
10010000P1
1111111111