1111111111
1001000001
10C1000001
1001000C01
1111000001
10C1000001
100000E001
1000C00001
10000000P1
1111111111