1111111111
1P01000001
1101011101
100001E001
1111011111
1010000101
1010100101
1010111101
1000C00001
1111111111