1111111111
1P01C00001
1101011101
100001E001
1111011111
1C100001C1
101010C101
1010111101
1000C00001
1111111111