1111111111
10C0000001
1000E00001
1000000001
1111011111
1000000001
10C00P0001
1001000001
100100C001
1111111111