1111111111
1C0100C001
1101011101
1000010E01
1111011111
10100001C1
1010100101
1010111101
1C000000C1
1111111111